_SDCSR = ShippingDetails.CalculatedShippingRate
_SDSSO = ShippingDetails.ShippingServiceOptions
_SDISSO = ShippingDetails.InternationalShippingServiceOption
account = アカウント
active = 出品中
add = 出品
addnewitem = 新規商品作成
AdditionalCheckoutInstructions = Additional checkout instructions
addebayaccount = Add eBay Account
allitems = 全ての商品
AutoPay = Auto Pay
BestOfferAutoAcceptPrice = Best Offer Auto Accept Price
BuyerGuaranteePrice = Buyer Guarantee Price
BuyerRequirements = Buyer Requirements
BuyItNowPrice = Buy it now price
cancel = キャンセル
Category = カテゴリ
CategoryAndTitle = カテゴリとタイトル
checkall = All
checkallpage = All pages
copy = コピー
Condition = 商品の状態
Cost = Cost
Country = 国
Currency = 通貨
delete = 削除
description = 説明
Description = 説明
detail = 詳細
Dimensions = Dimensions
edit = 編集
end = 終了
Handlingtime = Handling time
HitCounter = Hit Counter
itemid = Item ID
ItemSpecifics = Item Specifics
ListingDesigner = Listing Designer
ListingDuration = Listing Duration
ListingType = Listing Type
LoadingItemData = 商品データを読み込み中です ...
loading = Loading2
Location = Location
LotSize = Lot Size
MinimumBestOfferPrice = Minimum Best Offer Price
now = Now
Options = Options
Other = Other
Packagetype = Package type
Payment = Payment
PaymentMethods = Payment Methods
pict = Pict
Pictures = Pictures
PostalCode = 郵便番号
Price = 価格
PrivateListing = Private Listing
ProductDetails = Product Details
Quantity = 個数
relist = 再出品
ReturnPolicy = Return Policy
revise = 編集
SalesTax = Sales Tax
saved = 保存済み
save = 保存する
scheduled = 出品予約中
search = 検索
SelectDesign = Select Design
SelectTheme = Select Theme
Services = Services
setting = 設定
Setting = 設定
settings = 設定
Shipping = Shipping
Shippingtype = Shipping type
Shipto = Ship to
signout = Sign out
Site = Site
sold = 落札あり
StartPrice = 開始価格
subtitle = subtitle
title = タイトル
trash = ごみ箱
unanswered = 未回答
uncheckall = クリア
unsold = 落札なし
UserID = User ID
UPC = UPC
verify = Verify
Weight = Weight
